1111111111111111111111
1E0000C00C000C00001111
1C0B000000000000011111
1C0000000C00010B10B001
10101B1010010110000001
1010101011B10B01000101
10P0000C0C000000C011C1
1111111111111111111111