1111111111111111111111111
1E0000C00C000C00001100C11
1C0B0000000000000111C0011
1C0000000C00010B10B000B01
10101B1010010110000000001
1010101011B10B01000100001
10P0000C0C000000C011C01C1
1111111111111111111111111