1111111111111111111111
1E000000C000000C000C01
1C0B0000B0000000000001
1C0000000000000C000101
101001B100100000101101
1010010010111B10B01001
100P00000C00C000000001
1111111111111111111111