111111
1PB001
10C001
1C00E1
111111